503 - Service Unavailable
An Interactive Fiction by Horace The Endless Server Technician
Release 1 / Serial number 120428 / Inform 7 build 6E72 (I6/v6.31 lib 6/12N) SD

HTTP Error
You are standing at the entrance to Castle Shotgun. The gates are securely locked, with an unappealing sign on the front. The sign reads "Whoops! RPS is having a bit of a wobbly. Don't worry, we'll be back soon!"

To the left of the gates is a large opening in the wall, which Jim is leaning into. John is perched on a small rock nearby, while Alec and Tim are standing on the other side of the gates. A pile of magazines is scattered in a corner.

You can see Nathan, Lewie, Jim, John, Tim, Alec, Adam and a Refresh Button here.

>inv
You are carrying:
  a strange love of jetpacks
  an opinion on just about everything

>look at strange love of jetpacks
You've had this for as long as you can remember, and why not, indeed.

>give strange love of jetpacks to john
They already have one.

* * *

>inv
You are carrying:
  a strange love of jetpacks
  an opinion on just about everything

>look at opinion
You're not really sure where you got this from, but gosh darn if it isn't usable in plenty of places.

>give opinion to John
John doesn't seem interested.

* * *

>look at Alec
On closer inspection, Alec appears to be gluing bits of Warhammer 40k model armour to his shoulders and chest.

 Alec clears his throat and tests out his Librarian imitation. It's not bad.

>look at Alec
On closer inspection, Alec appears to be gluing bits of Warhammer 40k model armour to his shoulders and chest.
 He picks up a plastic lascannon and tries it out on his left nipple.

* * *

>look at Alec
On closer inspection, Alec appears to be gluing bits of Warhammer 40k model armour to his shoulders and chest.

 Alec clears his throat and tests out his Librarian imitation. It's not bad.

>push f5
Jim looks up from his work. "Don't even think about it."

* * *

>look
HTTP Error
You are standing at the entrance to Castle Shotgun. The gates are securely locked, with an unappealing sign on the front. The sign reads "Whoops! RPS is having a bit of a wobbly. Don't worry, we'll be back soon!"

To the left of the gates is a large opening in the wall, which Jim is leaning into. John is perched on a small rock nearby, while Alec and Quintin are standing on the other side of the gates. A pile of magazines is scattered in a corner.

You can see Jim, John, Quintin, Alec and a Refresh Button here.

>look at magazines
You pick up one of the magazines. It's the latest issue of Guns And Conversation, John and Jim's fanzine that they distribute around Bath. The cover story promises "Semi-autos and small talk" and an interview with a man who has invented a talking gun.
 You notice a discarded copy of Amiga Power in the pile.

>look at amiga power
An old copy of some obscure, arcane tome. The glyphs on the front are mysterious, and appealing.

>take amiga power
You reach for the magazine, but as you touch it it disintegrates in front of your eyes. In its place are the feet of a man. That man is Kieron Gillen. He smiles down at you.

>look at kieron
Kieron's figure is hard to make out, as his very flesh appears to emanate a glowing white light. He floats approximately two inches off the ground, and is wearing glasses which, when peered into, appear to reflect visions of the future and past.
 He still looks a bit like Jason Statham though.

* * *

>look at magazines
You pick up a heavy book. It's a walkthrough to a game called You Have To Cut The Rope. You flick to page 587 of 900. It's an exploration of the game's characters, and the likeness to the Theseus myth. Interesting.

>look at magazines
You grab a magazine at random. It's the latest issue of The Cat magazine! You've read this issue at least four times though, so you put it back.

>look at magazines
You pick up one of the magazines. It's the latest issue of Guns And Conversation, John and Jim's fanzine that they distribute around Bath. The cover story promises "Semi-autos and small talk" and an interview with a man who has invented a talking gun.

>look at magazines
You pick up a magazine. It's an old copy of something called Amiga Power. You toss it back in the pile.

>look at magazines
You grab a magazine at random. It's the latest issue of The Cat magazine! You've read this issue at least four times though, so you put it back.

>talk to john
That's not a verb I recognise.

* * *

>fuck you
Hey! Language! Especially when we're around Quintin, he's had a bad enough example set for him as it is.

* * *

>talk to john
John holds his hand up and paws the air in front of you. "Mmmff."

>talking to john
That's not a verb I recognise.

* * *

>take jim
I don't suppose Jim would care for that.

* * *

>fuck this
Hey! Language! Especially when we're around Quintin, he's had a bad enough example set for him as it is.

>look
HTTP Error
You are standing at the entrance to Castle Shotgun. The gates are securely locked, with an unappealing sign on the front. The sign reads "Whoops! RPS is having a bit of a wobbly. Don't worry, we'll be back soon!"

To the left of the gates is a large opening in the wall, which Jim is leaning into. John is perched on a small rock nearby, while Alec and Quintin are standing on the other side of the gates. A pile of magazines is scattered in a corner.

You can see Jim, John, Quintin, Alec and a Refresh Button here.

>take button
That's fixed in place.

>push button
Jim looks up from his work. "Don't even think about it."

>press button
Jim looks up from his work. "Don't even think about it."

>hit button
Violence isn't the answer to this one.

* * *

>give opinion to john
"Uh... maybe later."

>inv
You are carrying:
  a strange love of jetpacks
  an opinion on just about everything

* * *

>look at hole
You peek at the hole in the wall. There is a mess of wiring and tubes, and what appears to be the midriff of a particularly long animal. You peer down the inside of the wall in both directions, but see no evidence of legs or a head.

>look at opening
You peek at the hole in the wall. There is a mess of wiring and tubes, and what appears to be the midriff of a particularly long animal. You peer down the inside of the wall in both directions, but see no evidence of legs or a head.

* * *

>look at Nathan
Nathan is standing looking grumpily at his getup, which appears to be a weird blend of cowboy hat, Elvis suit, and stars-and-stripes-themed Converse. He notices you looking at him. "Always read contracts, reader. Always, always read contracts before you sign them."

He reaches into the Elvis suit, produces a small apple pie, and eats it. "It's not all bad, I suppose."

>look at Lewis
You can't see any such thing.

>look at Lewiw
You can't see any such thing.

>look at Lewie
You can't be certain, but it seems that whichever angle you view Lewie from, some kind of angelic glow emanates from behind him. As you approach, he turns to you and smiles. The wallet in your back pocket suddenly feels heavier.

>look at Adam
Given that it's been a fair few decades since he did anything major in economics, Adam is looking suprisingly sprightly. He's sitting in front of a large board which seems to represent the entirety of Castle Shotgun. Tiny figurines are standing on hexes on the grid, representing the various writers, and an army of HTTP error codes.

He picks up the model of John and starts making machine gun noises towards the HTTP error models..

* * *

>fart
Really? I mean, really? I know that, by anticipating this action, I am partly admitting that I would consider it myself, but we're at Castle Shotgun here. We have standards. Few standards, for sure, but some.

>take magazines
That's hardly portable.

* * *

>hit f5
You must supply a noun.

>hit button
You must supply a noun.

* * *

>talk to jim
Jim doesn't take his head out of the hole in the wall. You hear him muttering to himself.

"It's never the... well, except that one time when..."

>talk to jim
Jim doesn't take his head out of the hole in the wall. You hear him muttering to himself.

"Yes, it must be the... no, unless it's the... Hmm."

>talk to jim
Jim doesn't take his head out of the hole in the wall. You hear him muttering to himself.

"Of course, it could be the, uh..."

>talk to jim
Jim doesn't take his head out of the hole in the wall. You hear him muttering to himself.

"Yes, it must be the... no, unless it's the... Hmm."

* * *

>his f5
That's not a verb I recognise.

>hit button
Jim looks up from his work. "Don't even think about it."

>hit f5
Jim looks up from his work. "Don't even think about it."

* * *

>talk to quinns
Quintin remains stoic, staring off into the distance. His cape flaps about a bit in the wind, as if in response to your query.

>talk to alec
Alec seems a bit involved with sticking plastic armour to himself to reply. It's probably best to leave him alone when he's arming up, anyway.

>look at alec
On closer inspection, Alec appears to be gluing bits of Warhammer 40k model armour to his shoulders and chest.

 He looks at you disapprovingly as you stare at his Carnifex.

>look at Quintin
Quintin is standing on a small outcrop, hands on hips, looking out eastwards. Unfortunately, east of here is just the M4 corridor, but east is the direction heroes look in, as evidenced by his stony glare.
 The cape is probably a bit much though, you think to yourself.

>look at john
John sits hunched over on a stone at the foot of Castle Shotgun's walls, head in hands groaning to himself. There are several empty rum bottles nearby, one of which appears to have an Asda logo on it.

>talk to john
John looks up. "Hmm? No, I didn't lock us out. We're just having a bit of trouble with Horace. We'll have it working again in a tick."

He resumes nursing his headache.

>look
HTTP Error
You are standing at the entrance to Castle Shotgun. The gates are securely locked, with an unappealing sign on the front. The sign reads "Whoops! RPS is having a bit of a wobbly. Don't worry, we'll be back soon!"

To the left of the gates is a large opening in the wall, which Jim is leaning into. John is perched on a small rock nearby, while Alec and Quintin are standing on the other side of the gates. A pile of magazines is scattered in a corner.

You can see Jim, John, Quintin, Alec and a Refresh Button here.

>inv
You are carrying nothing.

* * *

>look at jim
His top hat and procedurally-generated facial hair gives him away in a second - this is Jim Rossignol, wordsmith and crazed steampunk inventor.

Jim is hunched over an opening in the Castle Shotgun walls, from which various wires are trailing. There is the occasional spark and fizz as he rummages around.